###############################################################################################################################################################
#                                                                                   ########                        ########                                  #
#         #    #########       ###       ###         ####             #   #         ######                  ################                                  #
#         #    #               ####                      ###          ##  ###       #####               ####################                                  #
#         #    #               ####                      ###          ##  ###       ###                 ####################                                  #
###########   ###       ###########  ###                 ####################                          #####################                                  #
###########   ###       ###########          ###         ###################################################################                                  #
############  #####################                ####  ###################################################################                                  #
#          #  ######                                              ##              ####                 #####################                                  #
########   ####                        #####                      ##              ####                                     #                                  #
#          ####                 ##########################     ########          ####            #####               #######                                  #
######     ####                 ##########################       ######          ####            #############       #######                                  #
######     #######   ##         ##########################       ######          ####            ################        ###                                  #
######     #######   ##              #####################       ######          #####           ##################     ####                                  #
######     ######     #              #####################                                       #################      ####                                  #
#               ####   ######           ###################################           ##########################      ######                                  #
###     ####     ####    ####                                                         ########################      ########                                  #
###     ####     ############               #######################                         ##################      ########                                  #
###     ####         ##########################                      ##############    ########################     ########                                  #
###     ####                                       ######                                   ###################     ########                                  #
#####################################      ####################    #####################    ##########                     #                                  #
########               ########                                                             ##########                     #                                  #
########               ####################      ######     ########     ############       ##########                     #                                  #
########               ############              ######        #####     ####               ##########                     #                                  #
############################################################################################################################                                  #
#                                                                                                                          #                                  #
#                                                                                                                          #                                  #
#                                                                                                                          #                                  #
#                                                                                                                          #                                  #
#                                                                                                                          #                                  #
#                                                                                                                          #                                  #
###############################################################################################################################################################